1111111111111
10010000000P1
1000011111001
100011E000001
1111111111111
